1111111111
1000P00001
1011111101
1000E00001
1011111101
1000000001
1111001111
1110000111
11C0000C11
1111111111
