111111111111111
1P00000C00000C1
10C0000C0000C01
100C000C000C001
1000C00C00C0001
10000C0C0C00001
100000C0C000001
1000000C0000001
1000000E0000001
111111111111111
