111111111111111111111111111111
100000000000000000000000000001
1011C111111110111111111C111101
1011111111111P1111111111111C01
1011E1111C111111C111111C111101
100000000000000000000000000001
111111111111111111111111111111
