111111111111111111111111111111
100000000000000000000000000001
1011C1111C111111C111111C111101
10C111111111111111111111111C01
1011C1111C111111C111111C111101
100000000000000000000000000001
1011C11111111011C111111C111101
10C1111111111P1111111111111C01
1011C1111C111111C111111C111101
100000000000000000000000000001
100000000000000000000000000001
1011C1111C111111C111111C111101
10C111111111111111111111111C01
1011E1111C111111C111111C111101
100000000000000000000000000001
111111111111111111111111111111
