111111111111111111111111111111
11P111111111111111111111111111
110100000000000000000000000011
110101111111111111111111111011
110101000000000000000000001011
110101011111111111111111101011
110101000000000000000000101011
11010101C1C1C1C1C1C1C110101011
110101011C1C1C1C1C1C1C10101011
110101000000000000000000101011
110101111111111111111111101011
110100000000000000000000001011
110111111111111111111111111011
110000000000000000000000000011
11E111111111111111111111111111
111111111111111111111111111111
