111111111
111TTT111
11T000T11
11TP0ET11
1TTTCTTT1
1TCCCCCT1
1TCCCCCT1
1TCCCCCT1
11TTTTT11
111111111
