1111111111
1000P00001
1011111101
1000E00001
1011111101
1000000001
1000110001
1000110001
10C0110C01
1111111111
