11111
1C0E1
11011
1P001
11111
