11111111111111111111
11111111111111111111
11111111P00E11111111
11111111000011111111
11111111100111111111
11111111100111111111
11000000000000000011
11001111111111110011
110000C111111C000011
11111111111111111111
