1111111111
1P00000001
1101111011
1000000001
1011111101
1E00000001
1111111111
