1111111111
100000E001
11C1111001
1000000001
1011111101
100000P001
1111111111
