1111111111
1PPPPPPPP1
1101111001
1CCCCCCCC1
1011111101
1EEEEEEEE1
1111111111
