1111111111
1PS0000001
1101111011
10SSS00C01
1011111101
1E000000T1
1111111111
