1111111111
1P00000001
1101111001
1CCCCCCCC1
1011111101
1000000001
1111111111
