1111111111
1000000001
1101111001
1CCCCCCCC1
1011111101
1E00000001
1111111111
