1111111111
1P000000011
11011110011
10C0C0C0C1
10111111011
1E000000011
1111111111
