1111111111
1P00000001
1101111001
1C00000001
1011111101
1000000000
1111111111
