1111111111
1000P00001
10fbbbbg01
10v0000n01
10v0000n01
10v0000n01
10v0000n01
10jmmmmh01
1C000000E1
1111111111
