11111111111
10000P00001
1000CCC0001
100T000T001
10TTTCTTT01
10TTTCTTT01
100TTCTT001
1000TCT0001
10000C00001
10000E00001
11111111111
