1111111111
1000P00001
10fvvvvg01
10b0000n01
10b0fg0n01
10b0jh0n01
10b0000nT1
10jmmmmh01
1C000000E1
1111111111
