1111111111
10T0P00T01
1011001101
10TT00TT01
1000000001
100T00T001
10T1001101
10110011T1
1C000000E1
1111111111
