1111111111
1000P00001
10fg00fg01
10jh00jh01
1000fg0001
1000jh0001
10fg00fg01
10jh00jh01
1C000000E1
1111111111
