111111111111
10000P000001
100110011001
100110011001
10000000T001
100000000001
100000000001
100000000001
100110011001
100110011001
100110011001
100110011001
100110011001
10C000000E01
111111111111
