1111111111
1000P00001
1011001101
1011001101
1000110001
1000110001
1011001101
1011001101
1C000000E1
1111111111
