1111111111
1000P00001
10vvvvvv01
1000000001
10mmmmmm01
1000000001
10jhjhjh01
1000000001
1C000000E1
1111111111
