1111111111111111
1TTTTTTTTTTTTTT1
1TP0TTTTTTTTTTT1
1TT0CTTTTTTTTTT1
1TTT0CTTTTTTTTT1
1TTTT0CTTTTTTTT1
1TTTTT0CTTTTTTT1
1TTTTTT0CTTTTTT1
1TTTTTTT0CTTTTT1
1TTTTTTTT0CTTTT1
1TTTTTTTTT0CTTT1
1TTTTTTTTTT0CTT1
1TTTTTTTTTTT0ET1
1TTTTTTTTTTTTTT1
1111111111111111
