1111111111
1000P00001
1011001101
1000000T01
1000T00001
1000000001
10T1001101
10110011T1
1C000000E1
1111111111
