11111111111
1PCCCCCCCC1
1TTT00TTTT1
1TTTT00TTT1
1TTTTT00TT1
1TTTTTT00T1
1TTTTTTT001
1TTTTTTTT01
1TTTTTTTTE1
11111111111
