11111111111111111111
1TTTTTTTTTTTTTTTTTT1
111111111T1111111111
1CCCCCCCCCCCCCCCCCP1
1C1111111T1111111111
1CCCCCCCCCCCCCCCCCC1
111111111T11111111C1
1CCCCCCCCCCCCCCCCCC1
1C1111111T1111111111
1CCCCCCCCCCCCCCCCCC1
111111111T11111111C1
1ECCCCCCCCCCCCCCCCC1
111111111T1111111111
1TTTTTTTTTTTTTTTTTT1
11111111111111111111
