1111111111
1000P00001
1011001101
10T0000T01
1000TT0001
1000000001
10T1001101
1011TT11T1
1C000000E1
1111111111
