11111111111
10000000001
100TCCCT001
10TTTCTTT01
10TTTTTTT01
100TTTTT001
1000TTT0001
10000T00001
1E0000000P1
11111111111
