11111111111
111TTTTT111
11TCTPTCT11
1TCCTCTCCT1
1TCCCCCCCT1
1TCCTCTCCT1
11TCTETCT11
111TTTTT111
11111111111
