1111111111111
1111111111111
1100CCCCC0011
110CCTCTCC011
110CTTCTTC011
11CTTTPTTTC11
110CTTCTTC011
110CCTCTCC011
11000CEC00011
1111111111111
1111111111111
